18.3858795160002,43.8864669800001 
18.3905239110001,43.8814353950002 
18.3961963650002,43.8770217900001 
18.3980884560001,43.8726081860001 
18.3980884560001,43.8663063060001 
18.3980884560001,43.859371186 
18.4012393960001,43.8530654900002 
18.4025001530002,43.8511772160001 
18.3993492120001,43.8511772160001 
18.3898925790001,43.8480224610001 
18.3740577700001,43.8474159250002 
18.3741340630001,43.8480224610001 
18.3716125480001,43.851806641 
18.367198943,43.8555908210001 
18.3665695190002,43.861892701 
18.3690910340002,43.869457246 
18.3690910340002,43.8751296990001 
18.3696994780001,43.8830451970001 
18.3722419740001,43.8833274830002 
18.3816986080001,43.8839569100001 
18.3858795160002,43.8864669800001